100,100,100,100,100,,,,
100,100,100,100,100,100,,,
100,100,100,100,100,100,100,,
100,100,100,100,100,100,100,100,
100,100,100,100,101,101,101,101,201,
100,100,100,100,100,100,100,100,
203,103,103,100,100,100,100,,
100,100,100,100,100,100,,,
100,100,100,100,100,,,,
306,301,303,304,,,,,